1111111111111
1P00C00000001
1000000000001
1000000000001
1000000000001
1000000000001
1111111111111