1111111111
1P00000001
100000C001

1000000001
10000000E1
1111111111

