111111111111111111111111111111111111
1P01100000000000000000000000000000E1
10C100000000000000000001000000000001
101100000000010000C00000001000000001
100000011100000000000100000010010001
100000000000000100000100100001000001
10000001110000000X000000000000100101
100000000000000001000000000000101001
10000001100100000000000C000000001001
10000100100000C0000000000010000001C1
100000000000010000000000000000000011
100100000000000000100000000000000001
10000C0000000000C1000000000000C00001
110000001000000010000000100000000001
111111111111111111111111111111111111