111111111111111111111111111111111111
10P000000000000000000000000000E00001
10C000000000000000000000000000000001
100000000000000000C00000000000000001
100000000000000000000000000000000001
100000000000000000000000000000000001
10000000000000000X000000000000000001
100000000000000000000000000000000001
10000000000000000000000C000000000001
10000000000000C0000000000000000000C1
100000000000000000000000000000000001
100000000000000000000000000000000001
10000C0000000000C0000000000000C00001
100000000000000000000000000000000001
111111111111111111111111111111111111