1111111111111
1P00100010001
1000101010101
100C101010101
1011101010101
10000010001E1
1111111111111