1111111111111
1P00C00000001
1000000000001
1000000000001
1000000000001
10000000000E11
1111111111111
1