11111111111111
1000000000E001
10000000000001
1P0000C0000001
1000000000C001
100C00000X0001
11111111111111