111111111111111111111111111111111111
1P001000100000000000000000000000X001
100010101010111111111111111111000001
100C10101010000000000000000001000001
101110101010111101111111111001000C01
100000101010000000000000001001000001
100000001000000000001000001001111111
1000000010000000000010000010000000C1
100000001111111000001000001111111111
100000000000000000001000000000000001
100000011111111000001000001111111001
10000C010000000000001000001000001001
100000011111111111111111111000001001
10000000000000000C000000000000001EC1
111111111111111111111111111111111111